companion - spolecnik
clues - voditka
swiftly - rychle
say farewell - rozloucit se
pacing up and down - chodit sem a tam
recognizable - rozeznat
gaunt - vyhubly
cloak - plast
deerstalker hat - lovecka cepice

rely on somebody - spolehat se na nekoho
carriage - vagon
ourselves - pro sebe
pile - hromada
udelat poznamku - udelat poznamku 
luggage - zavazadlo
rack - police
ordinary - obycejny
seems - zda se
against - proti

let out - pronajmout
neither - zadna
lake - jezero
servant - sluha
appointment - schuzka
gamekeeper - hajny
witness - svedek
lodgekeeper - vratny
pick - trhat

violent - ostry
quarrel - hadka
strike - uderit
almost - temer
run up - pribehnout
by the side of the pool - na brehu jezera
beat - rozbit
blows - udery
blunt - tupy
butt-end - pazba
arrest - zatknout
charge - obvinit
exceedingly grave - nesmirne vazne
indeed - vskutku
according to somebody - podle nekoho

a dreadful cry - priserny krik
precisely - presne
matter - zalezitost
refused - odmitnout
quite so - presne tak




